{
    "player1":{
        "town":[1,1]
    },
    "player2":{
        "town":[11,4]
    },
    
    "tileW":64,
    "tileH":64,
    "background":"background.png",
    "tilesets":["tiles.png"],
    "layers":[
        {
            "name":"tiles",
            "tileset":0,
            "tiles":[
                 [5,5,5,5,5,5,5,5,5,5,5,5,5,5,5,5,5,5],
                [5,1,1,1,1,1,1,1,1,1,1,1,1,1,1,5,5,5],
                 [5,1,1,1,1,1,1,1,1,1,1,1,1,1,1,5,5,5],
                [5,1,1,1,1,1,1,1,1,1,1,1,1,1,1,5,5,5],
                 [5,1,1,1,1,1,1,1,1,1,1,1,1,1,1,5,5,5],
                [5,1,1,1,1,1,1,1,1,1,1,1,1,1,1,5,5,5],
                 [5,1,1,1,1,1,1,4,4,1,1,1,1,1,1,5,5,5],
                [5,1,1,1,1,1,1,4,4,1,1,1,1,1,1,5,5,5],
                 [5,1,1,1,1,1,1,4,4,1,1,1,1,1,1,5,5,5],
                [5,1,1,1,1,1,1,1,1,1,1,1,1,1,1,5,5,5],
                 [5,1,1,1,1,1,1,1,1,1,1,1,1,1,1,5,5,5],
                [5,1,1,1,1,1,1,1,1,1,1,1,1,1,1,5,5,5],
                 [5,1,1,1,1,1,1,1,1,1,1,1,1,1,1,5,5,5],
                [5,1,1,1,1,1,1,1,1,1,1,1,1,1,1,5,5,5],
                 [5,5,5,5,5,5,5,5,5,5,5,5,5,5,5,5,5,5],
                [5,5,5,5,5,5,5,5,5,5,5,5,5,5,5,5,5,5],
                 [5,5,5,5,5,5,5,5,5,5,5,5,5,5,5,5,5,5],
                [5,5,5,5,5,5,5,5,5,5,5,5,5,5,5,5,5,5]
            ]
        }
    ]
}
